#######################################################################################################################################################
#        #                    #              #     #     #  #     #           #              #        #     #  #                    #  #              #
#  ####  ##########  ####  ####  ####  #  ####  #######  #  #  #  #  #######  #  #  ####  #######  #######  #  #  ####  #  #######  #  #  #######  ####
#  #     #     #        #  #  #  #     #  #     #     #  #     #        #        #  #        #     #  #        #     #  #     #  #           #        #
#  #  ####  ####  #  #  ####  ####  ####  #  ####  #  #  ####  ####  #  ####  ####  ####  #  ####  #  #  ###################  #  ##########  ##########
#  #  #        #  #  #  #        #     #     #     #  #     #  #     #     #     #     #  #        #     #        #  #     #     #  #     #  #     #  #
#  #  ####  #  #  ####  #######  #  #  ####  #  ####  ####  ####  ##########  #  ####  #  ####  ####  ####  #######  #  #  #  #  #  #  #######  #  #  #
X  #  #  #  #        #        #     #     #  #  #        #     #  #     #  #  #     #  #  #  #  #  #     #  #     #     #     #        #  #     #     #
####  #  ####  #  ##########  #  ####  #######  #############  #  #  #  #  ##########  ####  ####  #  ####  #  ##########  ####  #  #  #  #  ####  ####
#     #     #  #  #           #     #              #  #        #     #  #     #           #     #  #     #  #  #     #     #     #  #  #        #  #  #
#  ####  ####  #  ####  #  #  #  #  #  #  ##########  #  #  ####  ####  #  #######  #  #  ####  #  #  ####  #  ####  ####  ####  ####  #  ##########  #
#  #  #        #  #     #  #     #  #  #           #     #     #  #     #  #  #     #  #  #     #     #     #  #           #        #     #     #     #
#  #  #  ####  ##########  #  ##########  #  #  #######  #######  #######  #  #  #  ##########  #  #######  #  ####  ######################  #######  #
#  #     #  #     #     #  #        #     #  #        #                       #  #        #     #  #              #  #     #        #     #        #  #
#  #######  #  #  ####  #######  ####  ####  #######  #######  #  ####  #######  ####  #  #  ####  ####  #  ####  #  #  #  #  ##########  #  #######  #
#  #     #     #              #     #  #  #     #              #     #  #        #     #  #  #        #  #     #  #  #  #  #           #     #  #  #  #
#  ####  #######  ########## ###########  #  #  #  ####  #######  #############  ####  #  #  #  ####  ####  #######  #  ##########  ####  ####  #  #  #
#  #     #        #  #     #        #        #  #  #  #     #           #           #  #     #  #        #        #           #     #     #     #     #
#  #  ####  ####  #  ####  ####  ####  #  #######  #  #  ####  #  ######################  #  ####  #  #######  ##########  #######  #  ####  #  ####  #
#  #           #  #                 #  #  #           #  #  #  #           #        #     #  #     #  #  #        #              #  #     #  #  #     #
#  #  ####  #  ##########  ####  ####  #  #############  #  #######  #######  #######  ####  ####  #  #  #######  #######  #######  #  #  ####  #  ####
#  I     #  #  #  #           #  #     #           #     #        #     #  #        #  #     #     #  #        #                 #     #              #
#######  #######  ####  ################  #  #  #  #  #  ####  #######  #  #  ##########  #######  ####  #  ####  ####  #######  #  ##########  #######
#     #                       #        #  #  #  #  #  #     #           #  #           #     #     #  #  #  #     #     #        #           #     #  #
#  #######  #  ####  #  #  #  ####  #  ####  ####  ##########  ####  #  #  #  #  ####  #  #######  #  #  #  #  ####  #  ##########  ####  #  #######  #
#        #  #        #  #  #        #  #  #     #  #     #        #  #  #     #     #        #        #  #     #     #  #     #        #  #  #        #
#  #  #######  #  #############  ####     #  ##########  ######## ####  ################  #  ####  #  #  #  ##########  ####  #  #  #  #  #######  #  #
#  #           #     #           #  #  #  #  #        #  #        #                 #     #        #     #           #  #     #  #  #  #  #  #     #  #
#  #######  ####  ################  #  #  ####  #  #  #  #  #  #######  #  #######  #  #  #  #######  ####  ####  #######  ####  ####  ####  ####  ####
#  #  #  #     #  #              #     #     #  #  #     #  #        #  #  #     #  #  #  #  #        #     #  #           #  #     #     #     #     #
#  #  #  #  ####  #  #######  #  #  ####  ####  ####  #  #######  #  #  #  #  ####  ##########  #  ##########  #  ####  ####  ##########  ####  #  #  #
#  #           #  #        #  #  #           #  #  #  #        #  #  #  #  #           #  #     #        #     #  #                 #  #           #  #
#  ##########  #######  #  #  #### ##############  ####  #  #  #  ####  ######## #######  #  ####  #  #  ####  #  #######  #  #######  ####  ####  #  #
#  #           #  #     #  #           #              #  #  #  #  #  #        #        #  #  #  #  #  #     #  #  #  #     #     #        #     #  #  #
##########  ####  #  #######  ####  #######  #############  ####  #  #  ####  #  #######  ####  #  #  ####  #  ####  ####  ####  #  ####  #  #######  #
#  #  #  #     #     #     #     #  #        #  #        #  #     #     #  #     #        #        #  #        #        #  #  #        #  #     #     #
#  #  #  #  #  #  #  #  ##########  #  ####  #  #  #######  #  ##########  ####  ####  #######  #  #######  #  #  ####  #  #  #######  #######  #  ####
#     #     #  #  #     #  #              #  #           #        #        #     #        #  #  #     #     #  #  #  #        #                 #     #
#  #  #  ##########  ####  #  ####  #  #  ####  #  ####  ####  #  ####  ##########  ####  #  ####  #######  ####  #  #  #  #######  ################  #
#  #     #  #  #  #  #  #     #  #  #  #     #  #  #        #  #        #        #  #  #        #  #        #  #     #  #        #     #        #     #
#  #######  #  #  #  #  #  ####  #  ################  #  #  #######  ####  ##########  #  ####  #######  ####  ####  ###################  #######  #  #
#  #  #              #        #  #                 #  #  #  #  #  #        #     #        #                       #        #           #  #        #  #
####  #  ####  ##########  ####  ####  ####  #  #  #######  #  #  #  #  ####  ##########  #  ##########  #######  ####  #  ##########  #  ##########  #
#     #  #  #  #           #  #  #  #     #  #  #  #           #     #     #              #     #           #     #     #  #  #  #        #           #
#  #######  #  #  #  ####  #  #  #  #  ##########  ##########  ####  #  ####  ###################  ####  #############  ####  #  #  #  #  ####  #  #  #
#     #        #  #  #     #  #              #     #                 #              #  #     #  #     #  #     #  #              #  #  #  #     #  #  #
#  #######  #######  #  ####  #  #######  #  #  #  #  ####  ####  ####  #############  #  ####  #######  #  ####  #  ##########  #######  ####  ####  #
#  #        #  #     #        #     #     #  #  #  #  #        #  #  #     #              #     #  #     #     #        #  #  #  #           #     #  #
#  #######  #  ####  ####  ####  #  #############  #######  #######  #  #######  #  #  #  #  ####  ####  #  #  #  #  ####  #  #  #  #######  ####  #  #
#              #        #     #  #  #     #        #  #        #              #  #  #  #           #  #  #  #  #  #        #     #     #     #  #  #  #
#  #  #  #  #######  #  #  #  #  ####  #  #######  #  ####  ####  #  ######################  #  ####  ####  ####  ####  ####  #  #  #######  #  #  ####
#  #  #  #  #  #     #  #  #  #     #  #           #           #  #  #     #  #           #  #     #     #  #        #  #     #           #     #     #
#  ##########  ################  #######  #  ##########  ################  #  #######  ####  #  #  #  #  #  #  ####  #######  #  ####  #  #######  #  #
#  #        #        #        #     #     #  #  #                       #     #  #           #  #     #     #  #        #  #  #     #  #        #  #  #
#  ####  #  #  #  #######  #############  #  #  ####  ####  ####  #######  ####  ##########  #######  #  #  ####  #  #  #  #############  ####  ####  #
#     #  #     #  #        #              #              #     #  #  #           #  #  #        #     #  #        #  #  #     #  #  #  #     #  #  #  #
#  #  #  ####  ####  #  #  #  #  ################  #  ##########  #  #  ##########  #  #  #  ####  ####  #  #  #  #######  ####  #  #  #  #  ####  #  #
#  #  #  #  #  #  #  #  #  #  #  #           #  #  #           #  #        #  #        #  #     #  #  #  #  #  #     #     #  #     #  #  #     #     #
####  #  #  ####  #  #############  #######  #  #  #######  #  ####  #######  #  ################  #  ####  ####  #  #  ####  #  ####  #  ##########  #
#  #  #     #     #     #     #     #  #     #     #     #  #     #        #        #  #              #        #  #        #  #     #        #        #
#  ####  ####  ####  ####  ####  ####  ####  ####  #  #######  #  #  #  ####  #######  ####  #  #######  ##########  #  ####  ####  #  ####  #######  #
#  #                 #     #     #     #     #        #     #  #  #  #     #     #        #  #  #  #     #     #     #  #     #  #        #        #  #
#  #  ##########  #  ####  ####  #  #  ####  ####  #######  #######  ####  ####  #  #######  ####  #  ####  ####  ####  #  ####  ##########  ####  ####
#        #  #     #        #  #  #  #     #     #     #  #     #  #  #  #        #     #        #     #           #        #  #     #  #        #     #
##########  #  ##########  #  #  #  #  #######  #  ####  #  ####  #  #  #######  ####  #######  #  #  ####  #  #  ####  ####  #  ####  ####  #  ####  #
#     #              #           #  #  #  #           #                    #           #        #  #     #  #  #     #     #                 #     #  #
#  ####  #######  #  #  #  ####  #  ####  #  #  #############  ####  #######  #############  ################  #########################  ##########  #
#     #  #  #     #  #  #  #        #  #  #  #  #     #  #  #  #     #              #              #                 #     #  #     #  #        #  #  #
#  #######  #######  ####  ####  ####  #  ####  #  ####  #  #  ##########  #  #  ####  #  ################  ##########  ####  #  ####  #######  #  #  #
#        #           #        #        #  #  #              #           #  #  #  #     #  #              #  #  #     #        #           #  #     #  #
#######  #  #  #######  ####  #  ####  #  #  ####  #  #  #  #  ####  #############  #  ####  #######  #######  #  #  #  #  #  #  #######  #  #  #  #  #
#     #     #  #           #  #     #  #     #     #  #  #  #     #  #     #        #  #     #     #           #  #  #  #  #  #  #  #  #        #  #  #
#  ####  #  ####  #######  #######  #######  ##########  ####  ####  #  #######  ##########  ####  #  #  ####  #  ####  ##########  #  ####  #  #  ####
#     #  #     #     #  #  #                 #        #  #        #  #     #              #        #  #     #     #  #     #     #        #  #  #  #  #
#  #  #  #  ##########  ####  #  #  ####  #  #  #  #  ####  #  #  #  ####  #############  ####  ##########  #  ####  #  #  #  ##########  #  ####  #  #
#  #  #  #     #     #        #  #     #  #     #  #  #     #  #  #     #  #        #  #  #  #  #        #  #        #  #  #     #  #  #  #  #        #
####  #  ####  ####  ####  #  #######  ##########  ##########  ####  #  #  #  ####  #  ####  ####  ####  #  ####  #  #  #  #  ####  #  #  ##########  #
#     #  #     #           #  #  #     #        #  #  #  #        #  #     #     #           #     #     #  #  #  #  #  #           #                 #
#  #  ####  ##########  #######  ####  #  ####  #  #  #  ##########  ####  #######  ####  #  #  #  ##########  ####  #  ##########  #######  ####  ####
#  #     #  #                    #     #     #  #     #  #        #  #  #     #  #     #  #  #  #     #     #  #     #        #  #  #     #  #  #     #
#######  ####  ####  #######  #######  #  #  #  ####  #  ####  #  ####  #  ####  ####  ####  #  #######  #  #  #  #######  ####  ####  #  #  #  ####  #
#              #        #  #  #  #     #  #  #        #  #     #  #                       #        #  #  #  #           #        #     #  #  #        #
#  #############  #######  ####  #  ####  ####  #######  ####  ######################  #  ####  ####  #  ####  #  #  ####  #######  #  ####  #  ####  #
#  #  #  #  #     #     #        #  #     #              #  #        #     #        #  #     #        #        #  #     #  #  #     #     #  #  #     #
#  #  #  #  ####  ####  #######  ####  ####  #  ####  ####  #  #  ####  ####  ##########  ####  #######  #######  #  ####  #  ####  #  #  #  #  #######
#           #                 #        #  #  #     #  #        #     #        #  #  #  #  #     #  #  #        #  #     #  #     #  #  #     #  #     #
#  ####  #  ####  ####  ####  #  #  ####  ####  #  ####  #  #  #############  #  #  #  #######  #  #  #  ##########  ####  #  #  #  #############  ####
#     #  #  #        #  #     #  #  #  #     #  #        #  #  #              #  #     #  #     #  #  #           #        #  #     #     #  #     #  #
####  ##########  ####  ####  ####  #  ####  ####  ####  #  #  #######  ####  #  #  ####  #  ####  #  #############  ####  ####  ####  ####  ####  #  #
#        #     #  #     #     #     #              #     #  #     #        #     #     #        #  #     #        #  #     #     #           #        #
#  #  ####  ###############################  #  #  ####  #  ####  ####  #  #  ####  #######  ####  ####  ####  #######  #  ####  #######  #######  ####
#  #  #  #  #  #  #  #     #        #     #  #  #  #     #     #  #     #  #     #  #  #  #        #  #        #        #  #              #           #
####  #  #  #  #  #  #  ##########  ####  #  ##########  ######################  #  #  #  ####  #  #  #  #  ##########  #  ####  #  #  ####  ####  #  #
#     #  #        #        #     #              #  #     #           #  #  #                 #  #        #  #           #  #  #  #  #        #  #  #  #
#  #  #  ####  #  #  #######  ###################  ################  #  #  #  ####  #######  #  ##########  #############  #  #  ####  #  ####  #  ####
#  #  #        #           #  #        #           #              #        #     #  #  #        #     #  #     #                 #     #  #  #     #  #
#  #  #  #  #######  ####  #  ####  ####  ####  #  #############  #  ####  #######  #  #  ####  #  #  #  #  #######  ####  #######  #######  #######  #
#  #  #  #        #  #  #        #        #  #  #  #  #              #        #     #  #     #  #  #  #              #  #     #                 #     #
#  ####  ####  #######  #  #  ####  ####  #  #  #  #  #  ####  #  #######  #  #  ####  #######  #  #######  #  ####  #  #  #  #  #  #######  #  #  ####
#           #  #           #     #     #     #  #        #     #     #     #        #                 #     #     #  #     #  #  #     #     #        #
#######################################################################################################################################################
